#############################################################################################################################################################
####........................................#........................###........................................###......................#...#...#.......####
#......#.########################.#########.#.........................###.......................................#########..............#.#.#.#.#.#.#.###.####
#..#####.######....................####.....#.........................####.............................................................#...#...#...#.###.####
#.#......######....................####.....#...........................................################################################################.####
#.#......######......................................................................................................................................###.####
#.###########################################.################################################..............#........................................#...####
#...........................................#................................................#...............#.......................#################......#
#...........................................##########################################.......#....######......#.......###################.......######..###.#
#....................................................................................#.......#....####........##................................##...#####..#
#.........##########...............#..........................#......................#.......#......#####..############.........................####.####..##
#..................###.............#..........................#......................#.......#........##....##.......############...............##...###..###
#...................#..............###.............##########.#######.################.......#.........#....##....###############....#######...###...##..####
#...................#..............###.............#..........#......................##########################.####..........#########....#######...#..#####
#...................####...........#####...........#..........#.........##.............................#...................................####........######
#......................#...............#...........############.........###..........#.................#.............................................########
#......................#...............#.....................##.....#####............#.................##............................................########
#......................#...............####..................##......................###########........#..........#######...........................########
#...................###...................#...................#......................#..................###........#######...........................########
#...........#######.#.....................#..........................................##.########.........##........#######.................................##
#...........#.............................#.......########............................#...............####.........#######...........................#####.##
#...........###...........................#..............###..........................#..........######..............................................#####.##
#.........................................#...............#...........................#..............................................................#.....##
#.........................................############................................#..............................................................#......#
#############################################################################################################################################################