###################################################################################################
#.................................................................................................#
#.................................................................................................#
#.................................................................................................#
#.................................................................................................#
#.................................................................................................#
#.................................................................................................#
#.................................................................................................#
#.................................................................................................#
#...........................................TTT...................................................#
#.................................................................................................#
#.................................................................................................#
#.................................................................................................#
#.................................................................................................#
#.................................................................................................#
#..............................................@@@................................................#
#.................................................................................................#
#.................................................................................................#
#.................................................................................................#
#.................................................................................................#
#.................................................................................................#
#.................................................................................................#
#............................................................%%%%%%%%%%...........................#
#.................................................................................................#
#.................................................................................................#
#.................................................................................................#
#.................................................................................................#
#.................................................................................................#
#.................................................................................................#
###################################################################################################